00000000000000000000000000000000000000000000000000000000000000000
01111111111111111111111111111110000011111111111111111111111111110
01111111111111111111111111111110000011111111111111111111111111110
01111111111111111111111111111110000011111111111111111111111111110
01111111111111111111111111111111111111111111111111111111111111110
01111111111111111111111111111111111111111111111111111111111111110
01111111111111111111111111111111111111111111111111111111111111110
01111111111100111111111111111111111111111111111111110011111111110
01111111111111111111111111111111111111111111111111111111111111110
01111111111111111111111111111111111111111111111111111111111111110
01111111111111111111111111111111111111111111111111111111111111110
01111111111111111111111111111111111111111111111111111111111111110
01111111111111111111111111111111111111111111111111111111111111110
01111111111111111111111111111111111111111111111111111111111111110
01111111111111111111111111111111111111111111111111111111111111110
01111111111001111111111111111111111111111111111111110011111111110
01111111111101111111111111111111111111111111111111110111111111110
01111111111101111111111111111111111111111111111111110111111111110
01111111111101111111111111111111111111111111111111110111111111110
01111111111101111111111111111111111111111111111111110111111111110
01111111111101111111111111111111111111111111111111110111111111110
01111111111101111111111111111111111111111111111111110111111111110
01111111111101111111111111111111111111111111111111110111111111110
01111111111101111111111111111111111111111111111111110111111111110
01111111111101111111111111111111111111111111111111110111111111110
01111111111101111111111111111111111111111111111111110111111111110
01111111111101111111111111111111111111111111111111110111111111110
01111111111101111111111111111111111111111111111111110111111111110
01111111111101111111111111111111111111111111111111110111111111110
01111111111001111111111111111111111111111111111111110011111111110
01111111111111111111111111111111111111111111111111111111111111110
01111111111111111111111111111111111111111111111111111111111111110
01111111111111111111111111111111111111111111111111111111111111110
01111111111111111111111111111111111111111111111111111111111111110
01111111111111111111111111111111111111111111111111111111111111110
01111111111111111111111111111111111111111111111111111111111111110
01111111111111111111111111111111111111111111111111111111111111110
01111111111100111111111111111111111111111111111111110011111111110
01111111111111111111111111111111111111111111111111111111111111110
01111111111111111111111111111111111111111111111111111111111111110
01111111111111111111111111111111111111111111111111111111111111110
01111111111111111111111111111110000011111111111111111111111111110
01111111111111111111111111111110000011111111111111111111111111110
01111111111111111111111111111110000011111111111111111111111111110
00000000000000000000000000000000000000000000000000000000000000000
